1111111111
1000000001
1000000001
1000000001
1000030001
1000000001
1000000001
1002000001
1000000001
1211111111
