11111111111111111111111111111
10011111111111111111111111111
10001111211211211211211111111
10000112000000000000000021111
10000112111211121012111111111
10000000000000000000002111111
12111211121101112111211111111
11111111110000333111111111111
11111111000000000311111111111
11111111000000000311111111111
11111111000000000331111111111
11111200000070000003111111111
11111111000000003303111111111
11111111000000003404444411111
11111111110000003400000411111
11111111111000331144440411111
11111111111303444444150511111
11111111111300000004550511111
11111111111333444400000511111
11111111111111111155550511111
11111111111111111111115111111
